61
18
0 0 0 0 0 0 0 50 0 0 0 0 0 0 0 0 0 0 0 0 0 0 0 0 0 0 40 0 0 0 0 0 0 0 0 0 0 0 0 0 0 0 0 0 0 0 0 0 0 0 0 0 0 0 0 0 0 0 0 0 0 
0 0 0 0 0 0 0 50 0 0 0 0 0 0 0 0 0 0 0 0 0 0 0 0 0 0 40 0 0 0 0 0 0 36 37 38 0 0 0 0 36 37 38 0 40 0 0 0 0 0 0 0 0 0 0 0 0 0 0 0 0 
39 39 39 0 0 0 0 50 0 0 0 0 0 0 0 0 0 0 0 0 0 0 0 0 0 0 40 0 0 0 0 0 0 0 0 0 0 0 0 0 0 0 0 0 0 0 0 0 35 28 34 0 0 0 0 0 0 0 0 0 0 
0 0 0 0 0 0 0 50 0 0 0 0 0 0 0 0 0 0 0 0 0 0 0 0 0 0 26 0 0 0 36 23 24 0 0 0 0 22 23 38 0 0 0 0 0 0 0 26 31 27 30 0 0 0 0 0 0 0 0 0 0 
0 0 0 0 0 0 0 50 0 0 0 0 0 0 0 0 0 0 0 0 0 0 0 0 0 0 40 0 0 0 0 0 0 0 0 0 0 0 0 0 0 0 22 37 24 0 0 0 31 27 30 50 50 50 50 50 50 50 0 0 50 
0 0 0 0 0 0 0 50 0 0 0 0 0 0 0 0 0 0 0 0 0 0 0 0 0 0 40 22 23 38 0 0 0 0 22 37 24 0 0 0 0 0 0 0 0 0 0 0 31 27 30 0 0 0 0 0 0 0 0 0 50 
0 0 0 0 0 0 0 50 0 0 0 0 0 0 0 0 0 0 0 0 0 0 0 0 0 0 26 0 0 0 0 0 0 0 0 0 0 0 0 22 23 24 0 0 0 0 0 0 31 27 30 0 0 0 0 0 0 0 0 0 0 
0 0 0 0 0 0 0 50 0 0 0 0 0 0 0 0 0 0 0 0 0 0 0 0 0 0 26 0 0 0 0 36 23 24 0 0 0 0 0 0 0 0 0 0 0 0 0 0 31 27 30 0 0 0 0 0 0 0 0 0 0 
0 0 0 0 0 0 0 50 0 0 0 0 26 26 40 40 26 26 40 40 26 26 40 40 40 40 40 0 0 0 0 0 0 0 0 0 22 37 24 0 0 0 0 0 0 0 0 0 31 27 30 50 50 0 0 0 50 50 50 50 50 
0 0 0 0 0 0 0 50 0 40 0 0 0 0 0 0 0 0 0 0 0 0 0 0 0 0 40 0 36 37 38 0 0 0 0 0 0 0 0 0 0 22 23 38 0 0 0 0 31 27 30 0 0 0 0 0 0 0 0 0 0 
0 0 0 0 0 0 0 50 0 0 0 0 0 0 0 0 0 0 0 0 0 0 0 0 0 0 40 0 0 0 0 0 0 36 23 24 0 0 0 0 0 0 0 0 0 0 0 0 31 27 30 0 0 0 0 0 0 0 0 0 0 
0 0 0 0 0 0 0 0 0 0 40 0 0 0 40 0 0 0 40 0 0 0 40 0 0 0 40 0 0 0 0 0 0 0 0 0 0 0 22 37 24 0 0 0 0 0 0 0 31 27 30 50 50 50 50 50 0 0 0 50 50 
0 0 0 0 0 0 0 0 0 0 0 0 0 0 0 0 0 0 0 0 0 0 0 0 0 40 40 0 0 0 22 23 38 0 0 0 0 0 0 0 0 0 0 36 37 38 0 0 31 27 30 0 0 50 50 50 0 0 50 50 50 
0 0 0 0 0 0 0 0 0 0 0 0 0 0 0 0 0 0 0 0 0 0 0 0 0 0 40 0 0 0 0 0 0 0 0 36 23 24 0 0 0 0 0 0 0 0 0 0 31 27 30 0 0 0 0 0 0 0 0 0 0 
0 0 0 0 0 0 0 0 0 0 0 0 0 0 0 0 0 0 0 0 0 0 0 0 40 0 40 22 23 24 0 0 0 0 0 0 0 0 0 0 36 37 38 0 0 0 0 0 31 27 30 0 0 0 0 0 0 0 0 0 0 
0 0 0 0 0 0 0 0 0 0 0 0 0 0 0 0 0 0 0 0 0 0 0 0 0 0 40 0 0 0 0 0 22 23 38 0 0 0 0 0 0 0 0 0 0 0 0 0 31 27 30 0 0 40 0 40 0 0 0 0 0 
0 0 0 0 0 0 0 0 35 28 34 0 0 0 35 28 34 0 0 0 35 28 34 0 0 0 40 0 0 0 0 0 0 0 0 0 0 36 37 38 0 0 0 0 0 0 0 0 31 27 30 0 0 40 0 40 0 0 0 0 0 
0 0 0 0 0 0 0 0 31 27 30 0 0 0 31 27 30 0 0 0 31 27 30 0 0 0 40 0 0 0 0 0 0 0 0 0 0 0 0 0 0 0 0 0 0 0 0 0 31 27 30 40 40 40 39 40 40 40 40 40 40 
