71
18
0 0 0 0 0 0 0 0 0 0 0 0 0 0 0 0 0 0 0 0 0 0 0 0 0 0 0 0 0 0 0 0 0 0 0 0 0 0 0 0 0 0 0 0 0 0 0 0 0 0 0 0 0 0 0 0 0 0 40 0 0 0 0 0 0 0 0 0 0 0 0 
0 0 0 0 0 0 0 0 0 0 0 0 0 0 0 0 0 0 0 0 0 0 0 0 0 0 0 0 0 0 0 0 0 0 0 0 0 0 0 0 0 0 0 0 0 0 0 0 0 0 0 0 0 0 0 0 0 0 40 0 26 0 26 0 26 0 26 50 0 0 0 
0 0 0 0 0 0 0 0 0 0 0 0 0 0 0 0 0 0 0 0 0 0 0 0 0 0 0 0 0 0 0 0 0 0 0 0 0 0 0 0 0 0 0 0 0 0 0 0 0 0 0 0 0 0 0 0 0 0 40 0 0 0 0 0 0 0 0 0 0 39 39 
0 0 0 0 0 0 0 0 0 0 0 0 0 0 0 0 0 0 0 0 0 0 0 0 0 0 0 0 0 0 0 0 0 0 0 0 0 0 0 0 0 0 26 0 0 0 0 0 0 0 0 0 0 0 0 0 0 0 40 0 0 26 0 26 0 40 0 26 0 40 0 
28 28 28 34 0 0 0 0 0 0 0 0 0 0 0 0 0 0 0 0 0 0 0 0 0 0 0 0 0 0 0 0 0 0 0 0 0 0 40 0 0 0 0 0 0 0 0 36 37 37 37 37 37 37 37 38 0 0 40 0 0 0 0 0 0 0 0 0 0 40 0 
27 27 27 30 0 0 0 0 0 0 0 0 0 0 0 0 0 0 0 0 0 0 0 0 0 0 0 0 0 0 0 0 0 0 0 0 0 0 0 0 50 0 0 0 0 0 0 50 0 0 0 0 0 0 0 0 0 0 40 0 26 0 26 50 26 0 40 0 0 40 0 
27 27 27 30 0 0 0 0 0 0 0 0 0 0 0 0 0 0 0 0 0 0 0 0 0 0 0 0 0 0 0 0 0 0 0 0 40 0 0 0 50 44 44 44 50 50 50 50 0 0 0 0 0 0 0 0 0 0 40 0 0 0 0 0 0 0 0 0 0 40 0 
27 27 27 30 0 0 0 0 0 0 0 0 0 0 0 0 0 0 0 0 0 0 0 0 0 0 0 0 0 0 0 0 0 40 26 0 0 0 0 0 50 0 0 0 0 0 0 0 0 0 0 0 0 0 0 0 0 0 40 0 0 40 0 26 0 40 0 26 0 40 0 
27 27 27 30 0 0 0 0 0 0 0 0 0 0 22 23 38 0 40 0 0 0 0 0 0 0 0 0 0 0 0 0 0 0 0 0 0 0 0 0 50 0 0 0 0 0 0 0 0 0 0 0 0 39 39 39 39 39 40 0 0 0 0 0 0 0 0 0 0 40 0 
27 27 27 30 0 0 0 0 0 0 0 0 0 0 0 0 0 0 40 0 0 0 0 0 0 0 0 0 0 0 0 0 0 0 0 0 40 0 0 0 50 0 0 0 0 40 0 0 40 50 50 50 50 50 50 0 0 0 40 0 26 0 40 0 26 0 26 0 0 40 0 
27 27 27 30 0 0 0 0 0 0 0 36 37 38 0 0 0 0 40 0 0 0 0 0 0 0 0 0 0 0 0 0 0 0 0 0 0 0 0 0 50 0 0 0 0 0 0 0 50 0 50 0 0 0 0 0 0 0 40 0 0 0 0 0 0 0 0 0 0 40 0 
27 27 27 30 0 0 0 0 0 0 0 0 0 0 0 0 0 0 40 0 0 0 0 0 0 0 0 0 0 0 0 0 0 0 0 0 0 0 40 0 50 0 0 0 0 0 0 40 50 0 50 0 0 0 0 0 0 0 40 0 0 26 0 40 0 26 0 40 0 40 0 
27 27 27 30 0 0 0 0 22 23 24 0 0 50 50 50 50 50 40 0 0 0 0 0 50 10 2 2 2 2 2 2 12 50 50 0 0 0 0 0 50 0 0 0 0 0 0 0 0 0 50 0 0 0 0 0 0 0 40 0 0 0 0 0 0 0 0 0 0 40 0 
27 27 27 30 0 0 0 0 0 0 0 0 0 0 0 0 0 0 40 0 0 0 0 0 0 0 0 0 0 0 0 0 0 0 0 0 40 0 0 0 50 0 0 0 40 0 0 0 0 0 0 0 0 0 0 0 0 0 40 0 0 0 26 0 26 0 40 0 0 40 0 
27 27 27 30 0 36 37 38 0 50 50 50 50 0 0 0 0 0 40 0 35 28 28 34 0 0 0 0 0 0 0 0 0 0 0 0 0 0 0 0 50 0 0 0 0 0 0 0 0 0 0 0 0 0 0 0 0 0 0 0 0 0 0 0 0 0 0 0 0 40 0 
27 27 27 30 0 0 0 0 0 0 0 0 0 0 0 0 0 0 40 0 31 27 27 30 0 0 0 0 0 0 50 50 50 50 50 50 0 0 0 0 50 0 0 0 0 0 0 0 0 39 39 39 39 39 0 0 0 0 0 0 0 26 0 26 0 40 0 26 0 40 0 
27 27 27 30 0 0 0 0 0 0 0 0 0 0 0 0 0 0 40 0 31 27 27 30 0 0 0 0 0 0 0 0 0 0 0 0 0 0 0 0 50 0 0 0 0 0 40 0 0 0 0 0 0 0 0 0 0 39 39 39 0 0 0 0 0 0 0 0 0 40 0 
0 0 0 0 0 0 0 0 0 0 0 0 0 0 0 0 0 0 0 0 0 0 0 0 0 0 0 0 0 0 0 0 0 0 0 0 0 0 0 0 0 0 0 0 0 0 0 0 0 0 0 0 0 0 0 0 0 0 40 0 0 0 0 0 0 0 0 0 0 40 0 
