134
20
0 0 0 0 0 0 0 0 0 0 0 0 0 0 0 0 0 0 0 0 0 0 0 0 0 0 0 0 0 0 0 0 0 0 0 0 0 0 0 0 0 0 0 0 0 0 0 0 0 0 0 0 0 0 0 0 0 0 0 0 0 0 0 0 0 0 0 0 0 0 0 0 0 0 0 0 0 0 41 0 0 0 41 0 0 0 0 0 0 0 0 0 0 0 0 0 0 0 0 0 0 0 0 0 42 0 0 0 0 0 0 0 0 0 0 0 0 0 0 0 0 0 0 0 0 0 0 0 0 0 0 32 29 29 
0 0 0 0 0 0 0 0 0 0 0 0 0 0 0 0 0 0 0 0 0 0 0 0 0 0 0 0 0 0 0 0 0 0 0 0 0 0 0 0 0 0 0 0 0 0 0 0 0 0 0 0 0 0 0 0 0 0 0 0 0 0 0 0 0 0 0 0 0 0 0 0 0 0 0 0 0 0 41 0 0 0 0 0 0 0 0 0 0 0 0 0 0 0 0 0 0 0 0 0 0 0 0 0 42 0 0 0 0 0 0 0 0 0 0 0 0 0 0 0 0 0 0 0 0 0 0 0 0 0 0 32 29 29 
0 0 0 0 0 0 0 0 0 0 0 0 0 0 0 0 0 0 0 0 0 0 0 0 0 0 0 0 0 0 0 0 0 0 0 0 0 0 0 0 0 0 0 0 0 0 0 0 0 0 0 0 0 0 0 0 0 0 0 0 0 0 0 0 0 0 0 0 0 0 0 0 0 0 0 0 0 0 41 0 0 0 0 0 0 0 0 0 0 0 0 0 0 0 0 0 0 0 0 0 0 0 0 0 42 0 0 0 0 0 0 0 0 0 0 0 0 0 0 0 0 0 0 0 0 0 0 0 0 0 0 32 29 29 
0 0 0 0 0 0 0 0 0 0 0 0 0 0 0 0 0 0 0 0 0 0 0 0 0 0 0 0 0 0 0 0 0 0 0 0 0 0 0 0 0 0 0 0 0 0 0 0 0 0 0 0 0 0 0 0 0 0 0 0 0 0 0 0 0 0 0 0 0 0 0 0 0 0 0 0 0 0 41 42 0 0 41 0 0 0 0 0 0 0 0 0 0 0 0 0 0 0 0 0 0 0 0 0 42 0 42 0 0 0 43 0 0 0 43 0 0 39 23 39 23 39 23 39 0 0 0 0 0 0 0 32 29 29 
0 0 0 0 0 0 0 0 0 0 0 0 0 0 0 0 0 0 0 0 0 0 0 0 0 0 0 0 0 0 0 0 0 0 0 0 0 0 0 0 0 0 0 0 0 0 0 0 0 0 0 0 0 0 0 0 0 0 0 0 0 0 0 0 0 0 0 0 0 0 0 0 0 0 0 0 0 0 41 0 0 0 41 0 0 0 0 0 0 0 0 0 0 0 38 39 0 0 43 39 39 39 0 0 42 0 0 0 0 0 0 0 0 0 0 0 0 0 0 0 0 0 0 43 0 0 0 0 0 0 0 32 29 29 
0 0 0 0 0 0 0 0 0 0 0 0 0 0 0 0 0 0 0 0 0 0 0 0 0 0 0 0 0 0 0 0 0 0 0 0 0 0 0 0 0 43 0 0 0 0 0 0 0 0 0 0 0 0 0 0 0 0 0 0 0 0 0 0 0 0 40 41 0 0 0 0 0 0 0 0 0 0 41 0 0 42 41 0 0 0 0 0 0 0 0 0 0 0 0 0 0 0 41 0 0 0 0 0 42 0 0 0 42 0 0 0 43 0 0 0 10 2 2 2 2 12 0 41 0 0 0 0 0 0 0 32 29 29 
0 0 0 0 0 0 0 0 0 0 0 0 0 0 0 0 0 0 0 0 0 0 0 0 0 0 0 0 0 0 0 0 0 0 0 0 0 0 39 39 40 41 0 0 0 0 0 0 0 0 0 0 0 0 0 0 0 0 0 0 0 0 0 41 0 0 0 41 0 0 0 0 0 39 39 0 0 0 41 0 0 0 41 0 0 0 0 0 0 0 0 0 39 40 0 0 0 0 41 0 0 0 0 0 42 0 0 0 0 0 0 0 0 0 0 0 0 0 0 0 0 0 0 41 0 0 0 0 0 0 0 32 29 29 
0 0 0 0 0 0 0 0 0 0 0 0 0 0 0 0 0 0 0 0 50 50 0 0 0 0 0 0 0 0 0 0 0 0 0 0 0 0 0 0 0 41 38 39 40 0 0 0 0 0 0 0 0 0 0 0 0 0 0 0 0 0 0 0 0 0 0 41 0 0 0 39 40 0 0 0 41 0 41 42 0 0 41 0 0 0 0 0 0 0 0 0 0 0 0 0 0 0 41 0 0 0 0 0 42 0 42 0 0 0 0 0 0 0 0 0 10 2 2 2 2 12 0 41 0 0 0 0 0 0 43 32 29 29 
0 0 0 0 0 0 0 0 0 0 0 0 38 39 40 0 50 10 2 2 2 2 2 2 12 50 0 0 50 0 0 0 0 0 50 10 2 2 2 12 50 41 0 38 39 40 0 0 0 0 0 0 0 0 0 0 0 0 0 0 0 0 0 0 0 0 41 41 0 39 40 0 0 0 0 0 41 0 41 0 0 0 41 0 0 0 0 0 0 0 0 0 0 0 38 39 0 0 41 0 0 0 0 0 24 0 0 0 0 0 0 0 0 0 0 0 0 0 0 0 0 0 0 41 0 0 0 0 0 43 0 32 29 29 
0 0 0 0 0 0 0 0 0 38 39 40 0 0 0 0 0 0 0 0 0 0 0 0 0 0 0 0 0 0 0 0 0 0 0 0 0 0 0 0 0 41 0 0 38 39 40 0 0 0 0 0 0 0 0 0 0 0 0 0 0 0 0 41 0 0 0 41 0 0 0 0 0 0 0 0 41 0 41 0 0 42 41 0 0 0 0 0 0 0 0 0 0 0 0 0 0 0 41 0 0 0 0 0 24 0 0 0 42 0 0 0 0 0 0 0 10 2 2 2 2 12 0 41 0 0 0 0 43 0 0 32 29 29 
0 0 0 0 0 0 38 39 40 0 0 0 0 0 0 0 0 0 0 0 0 0 0 0 0 0 0 0 0 0 0 50 10 2 2 2 12 50 0 0 0 41 0 0 0 38 39 40 0 0 0 0 0 0 0 0 0 0 0 0 38 0 0 0 0 0 0 41 0 0 0 0 0 0 0 0 41 0 41 0 0 0 41 0 0 0 0 0 0 0 0 0 39 40 0 0 0 0 41 0 0 0 0 0 42 0 0 0 0 0 0 0 0 0 0 0 0 0 0 0 0 0 0 41 0 0 0 43 0 0 0 32 29 29 
30 30 30 30 30 36 0 0 0 0 0 0 0 0 0 0 0 0 0 0 0 0 0 0 0 0 0 0 0 0 0 0 0 0 0 0 0 0 0 0 0 41 0 0 0 0 38 39 40 0 0 0 0 0 0 0 0 0 0 0 0 0 0 0 0 0 0 41 0 0 0 0 0 0 0 0 41 0 41 42 0 0 41 0 0 0 0 0 0 0 0 0 0 0 0 0 0 0 41 0 0 0 0 0 42 0 42 0 0 0 0 0 0 0 0 0 0 0 0 0 0 0 0 41 0 0 0 0 0 0 0 32 29 29 
29 29 29 29 29 33 0 0 0 0 0 0 0 0 0 0 0 0 0 0 0 0 0 0 0 0 0 0 0 0 0 0 50 0 50 10 2 2 2 12 50 41 0 0 0 0 0 38 39 40 0 0 0 0 0 0 0 0 0 0 0 0 38 0 0 0 0 41 0 0 0 0 0 0 0 0 0 0 41 0 0 0 41 0 0 0 0 0 0 0 0 0 0 0 38 39 0 0 41 0 0 0 0 0 0 0 0 0 50 0 0 50 0 50 0 50 50 0 50 0 0 0 0 41 0 0 0 0 0 43 0 34 31 31 
29 29 29 29 29 33 0 0 0 0 0 0 0 0 0 0 0 0 0 0 0 0 0 0 0 0 0 0 0 0 0 0 0 0 0 0 0 0 0 0 0 41 0 0 0 0 0 0 38 39 40 0 0 0 0 0 0 0 0 0 0 0 0 0 0 0 0 41 0 0 0 0 0 0 0 0 41 0 41 0 0 42 41 0 0 0 0 0 0 0 0 38 39 40 0 0 0 0 41 0 0 50 10 2 2 2 2 2 2 2 2 2 2 2 2 2 2 12 50 0 39 39 39 41 0 0 0 0 0 0 0 0 0 0 
29 29 29 29 29 33 0 0 0 0 0 0 0 0 0 0 0 0 0 0 0 0 0 0 0 0 0 50 0 50 10 2 2 2 12 50 0 50 0 0 0 41 0 0 0 0 0 0 0 38 39 40 0 0 0 0 0 0 50 50 0 0 0 0 38 38 38 41 0 0 0 0 0 0 0 0 41 0 0 0 0 0 41 37 30 30 30 36 38 39 40 0 0 0 0 0 0 0 41 0 0 0 0 0 0 0 0 0 0 0 0 0 0 0 0 0 0 0 0 0 0 0 0 41 0 0 43 0 0 0 37 30 30 30 
29 29 29 29 29 33 0 0 0 0 0 0 0 0 0 0 0 50 0 0 0 0 0 0 0 0 0 0 0 0 0 0 0 0 0 0 0 0 0 0 0 41 0 0 0 0 0 0 0 0 38 39 39 0 50 10 2 2 2 2 2 2 12 50 0 0 0 41 0 32 29 29 33 0 41 0 41 0 41 0 42 0 41 32 29 29 29 33 0 0 0 0 0 0 0 0 0 0 41 0 0 0 0 0 50 0 0 0 0 0 0 0 0 0 0 0 0 0 0 0 0 0 0 41 0 0 0 0 0 0 32 29 29 29 
1 1 1 1 1 28 22 22 22 22 22 22 22 22 22 22 22 22 22 22 22 22 22 22 22 22 22 22 22 22 22 22 22 22 22 22 22 22 22 22 22 22 22 22 22 22 22 22 22 22 22 22 22 22 22 22 22 22 22 22 22 22 22 22 22 22 22 22 22 27 1 1 28 22 22 22 22 22 22 22 22 22 22 27 1 1 1 28 22 22 22 22 22 22 22 22 22 22 22 22 22 22 22 22 22 22 22 22 22 22 22 22 22 22 22 22 22 22 22 22 22 22 22 22 22 22 22 22 22 22 27 1 1 1 
22 22 22 22 22 22 22 22 22 22 22 22 22 22 22 22 22 22 22 22 22 22 22 22 22 22 22 22 22 22 22 22 22 22 22 22 22 22 22 22 22 22 22 26 22 22 22 22 22 22 22 22 22 22 22 22 22 22 22 22 22 22 22 22 22 22 22 22 22 22 22 22 22 22 22 22 22 22 22 22 22 22 22 22 22 22 22 22 22 22 22 22 22 22 22 22 22 22 22 22 22 22 22 22 22 22 22 22 22 22 22 22 22 22 22 22 22 22 22 22 22 22 22 22 22 22 22 22 22 22 22 22 22 22 
22 22 22 22 22 22 22 22 22 22 22 22 22 22 22 22 22 22 22 22 22 22 22 22 22 22 22 22 22 22 22 22 22 22 22 22 22 22 22 22 26 22 22 22 22 22 22 22 22 22 22 22 22 22 22 22 22 22 22 22 22 22 22 22 22 22 22 22 22 22 22 22 22 22 22 22 22 22 22 22 22 22 22 22 22 22 22 22 22 22 22 22 22 22 22 22 22 22 22 22 22 22 22 22 22 22 22 22 22 22 22 22 22 22 22 22 22 22 22 22 22 22 22 22 22 22 22 22 22 22 22 22 22 22 
22 22 22 22 22 22 22 22 22 22 22 22 22 22 22 22 22 22 22 22 22 22 22 22 22 22 22 22 22 22 22 22 22 22 22 22 22 22 22 22 22 22 22 22 22 22 22 22 22 22 22 22 22 22 22 22 22 22 22 22 22 22 22 22 22 22 22 22 22 22 22 22 22 22 22 22 22 22 22 22 22 22 22 22 22 22 22 22 22 22 22 22 22 22 22 22 22 22 22 22 22 22 22 22 22 22 22 22 22 22 22 22 22 22 22 22 22 22 22 22 22 22 22 22 22 22 22 22 22 22 26 26 26 26 
